


			N     	      assets/wall north.xpm
		SO 	assets/wall_south.xpm


C 155,40     ,100

EA assets/wall_east.xpm
W assets/wall_west.xpm


F 100,200,10

111111111111111
1111111000111111
11111000011
100S000111
10011101
1000011
111111
