NOT test.texture 
S XD
E bonsoir
W kek
C 155,10,100
F 100,200,10

	                
11111111111
10000001
1001
100001
111111