NO textures/n.xpm 
S textures/s.xpm
E textures/e.xpm
W textures/w.xpm
C 155,10,100
F 100,200,10



11111111111
11111111001
11111000001
100E000111
10011101
1000011
111111
