N		textures/n.xpm 

S	 textures/s.xpm


W textures/w.xpm

E textures/e.xpm
F      0,  2   ,  1
C 255, 255, 255

111111
1010111
1S11111
 1	